#########################
#....#.............#....#
#....#.............#....#
#BB###.............###BB#
#.......................#
#.......................#
#.......BBBBBBBB........#
#.......................#
##########BBBB###########
#.......................#
#.......BBBBBBBB........#
#.......................#
#BB###.............###BB#
#....#.............#....#
#....#.............#....#
#########################