#########################
#....#.....#.......#....#
#....#.....#.......#....#
#..###.....#.......###..#
#.....#....#............#
#......#...#......##....#
#.......#.........#.....#
#.......................#
########........#########
#.......................#
#.....#.........#.......#
#....##.....#....#......#
#...........#.....#.....#
#..###......#......###..#
#....#......#......#....#
#....#......#......#....#
#########################