#########################
#.....#.................#
##.................#.#.##
.#...###############.#.#.
.#.................#...#.
.#......#########.##...#.
.#...#..#..#.......#...#.
.#...#..#.#.....#..#...#.
.#...#..#....#..#..#...#.
.#...#.....#.#..#..#...#.
.#...#......#...#..#...#.
.#...#..#########......#.
.#...#.......#....###..#.
##..#........#....#....##
#....#.......#..#.......#
#...............#.......#
#########################